0,0,0,0,0,0,0,0,0,0,0,0,0,0,0,0,0,0,0,0
0,0,0,0,0,0,0,0,0,0,0,0,0,0,0,0,0,0,0,0
0,0,0,0,0,0,0,0,0,0,0,0,0,0,0,0,0,0,0,0
0,0,0,0,0,0,0,0,0,0,0,0,0,0,0,0,0,0,0,0
0,0,0,0,0,0,0,0,0,0,0,0,0,0,0,0,0,0,0,0
0,0,0,0,0,0,0,0,0,0,0,0,0,0,0,0,0,0,0,0
0,0,0,0,0,0,0,0,0,0,0,0,0,0,0,0,0,0,0,0
0,0,0,0,0,0,0,0,0,0,0,0,0,0,0,0,0,0,0,0
0,0,0,0,0,0,0,0,0,0,0,0,0,0,0,0,0,0,0,0
0,0,0,0,0,0,0,0,0,0,0,0,0,0,0,0,0,0,0,0
102,103,104,101,102,103,104,101,102,103,104,101,102,103,104,101,102,103,104,101
118,119,120,119,120,117,118,117,118,119,120,117,118,119,120,117,118,119,120,117
135,135,135,135,135,135,135,135,135,135,135,135,135,135,135,135,135,135,135,135
135,135,135,135,135,135,135,135,135,135,135,135,135,135,135,135,135,135,135,135
135,135,135,135,135,135,135,135,135,135,135,135,135,135,135,135,135,135,135,135
135,135,135,135,135,135,135,135,135,135,135,135,135,135,135,135,135,135,135,135
