0,0,0,0,0,0,0,0,0,0,0,0,0,0,0,0,0,0,0,0
0,45,46,0,0,0,0,0,0,0,0,0,0,13,14,0,0,0,0,0
0,0,0,0,0,0,0,0,0,0,0,0,0,29,30,0,0,0,0,0
0,0,0,0,0,0,0,0,0,0,0,0,0,0,0,0,0,0,0,0
0,0,0,0,0,0,0,31,0,0,0,0,0,0,0,0,0,0,0,0
0,0,0,0,0,0,0,0,0,0,0,0,0,0,0,0,45,46,0,0
0,0,0,0,0,0,0,0,0,0,0,0,0,0,0,0,0,0,0,0
0,0,0,0,0,0,0,0,0,76,76,0,0,0,0,0,0,0,0,0
76,76,0,0,0,0,76,76,0,92,92,75,75,0,75,76,75,0,75,75
92,92,75,76,76,76,92,92,75,92,92,91,91,76,91,92,91,75,91,91
91,91,91,91,91,91,91,91,91,91,91,91,91,91,91,91,91,91,91,91
91,91,91,91,91,91,91,91,91,91,91,91,91,91,91,91,91,91,91,91
91,91,91,91,91,91,91,91,91,91,91,91,91,91,91,91,91,91,91,91
91,91,91,91,91,91,91,91,91,91,91,91,91,91,91,91,91,91,91,91
91,91,91,91,91,91,91,91,91,91,91,91,91,91,91,91,91,91,91,91
91,91,91,91,91,91,91,91,91,91,91,91,91,91,91,91,91,91,91,91
