81,81,81,81,81,82,0,0,0,0
97,97,97,97,97,99,82,0,0,0
97,97,97,97,97,97,99,82,0,0
97,97,97,97,97,97,97,98,0,0
97,97,97,97,97,97,97,98,0,0
97,97,97,97,97,97,97,98,0,0
97,97,97,97,97,97,97,98,0,0
